10000000000000000000000000000000000011111111111111111111111111
10000000000000000000000000000000000000000000000000000000000001
10000000000000000000000000000000000000000000000000000000000001
10000000000000000000000000000000000000000000000000000000000001
10000000000000000000000000000001000011110011111111111111110011
10000000000000000011001010101011000011110011111111111111110011
10000010000000000000000000000001000010000000000000000000000011
10000000000000000000000000000001000010000000000000000000000011
11000000000000000000000000000001000011111111111100111111111111
11100000000000001000000000000001000000000000000000000000000001
11111111111111111111111111111111000000000000000000000000000001
11111111111111111111111111111111111133333333333331111111111111
