30000000000000000000000000000000000033333333333333333333333333
30000000000000000000000000000000000000000000000000000000000003
30000000000000000000000000000000000000000000000000000000000003
30000000000000000000000000000000000000000000000000000000000003
30000000000000000000000000000003000033330033333333333333330033
30000000000000000033003030303033000033330033333333333333330033
30000030000000000000000000000003000030000000000000000000000033
30000000000000000000000000000003000030000000000000000000000033
32000000000000000000000000000003000033333333333300333333333333
33200000000000003000000000000003000000000000000000000000000003
33333333333333333333333333333333000000000000000000000000000003
33333333333333333333333333333333333333333333333333333333333333
