30000000000000000000000000300000000000000000000000000000000003
30000000000000000000000000300000000000000000000000000000000003
30000000000000000000000000300000000300000000000000000000000003
30000000000000000000000000300000000300000000000000000000000003
30000000000000000000000000300000000300000000000000000000000003
30000000000000000000000000300000000300000000000000000000000003
30000000000000000000000000300000000300000000000000000000000003
30000000000000000000000000000000000300000000000000000000000003
30000000000000000000000000000000000300000000000000000000000003
30000000000000000000000000000000000300000000000000000000000003
33333333333333333333333333300000000300000000000000000000000003
33333333333333333333333333300000000333333333333333333333333333
